1111111111111
10010000CC011
1001011111001
11P0011E00001
1000010C00001
1111111111111