111111111111111111
101000000000000001
1000000000000C00C1
1000000000E0000011
100000000000000P01
111111111111111111
