11111111111111
1E000000C00C01
10101000010101
10100111001111
1100C0C0000PC1
11111111111111